Gibberbot	mobile
havrobase	development
ghapi	development
UniversalAndroot	mobile
android_packages_apps_Gallery3D	mobile
aws-sdk-for-android	mobile
cassandra	databases
persist	databases
spring-android	mobile
android-xbmcremote	mobile
j4-minimal	webapps
hank	databases
yuicompressor	other
lesscss-servlet	webapps
android_packages_apps_Camera	mobile
groovy	development
strest-server	networking
jredis	other
sonar	development
Essentials	other
PBLabsProfiler	other
riak-java-client	databases
leveldbjni	databases
mp3agic	other
android	mobile
hurricane	networking
JHaml	other
mongo-java-driver	databases
substance	other
lesscss-engine	development
greplin-lucene-utils	other
Towny	games
mumble-android	mobile
antlr	other
storm	other
osw-web	webapps
LEGO-MINDSTORMS-MINDdroid	mobile
rockonnggl	other
drools-planner	other
scribe-java	other
dashboard	other
bigbluebutton	other
QuasselDroid	mobile
summer	development
coffee-brew	editors_IDE
jline	other
NewQuickAction	mobile
solr-spatial-light	other
old-redline-smalltalk	other
Drools_jBPM5-Training-Examples	other
NoCheat	games
grails-maven	other
JMongoBrowser	databases
HBaseHUT	databases
okjsp-site	other
encog-java-core	other
voldemort	databases
hadoop2solr	databases
vjet	editors_IDE
Levelcraft	games
Arduino	other
android_packages_apps_VoiceDialer	mobile
quickstarts	webapps
logback	loggers
Force.com-Toolkit-for-Android	mobile
clj-ds	development
brcm-accounts-api	other
java-classmate	development
comm	other
jackson-module-hibernate	other
maven-3	development
JGroups	networking
Something-Awful-Android	mobile
behemoth	other
Hudson-GIT-plugin	development
pignlproc	other
robolectric	development
github-plugin	development
HNdroid	mobile
parboiled	other
ActionBarSherlock	mobile
platform_packages_apps_email	mobile
oddities	other
kahlua2	other
ruby-mine-settings	other
riak-java-pb-client	networking
Craftbukkit	games
vrapper	editors_IDE
initializr	other
tapestry5	other
curator	other
email-ext-plugin	other
clojure	development
android_packages_apps_Launcher2	mobile
jsoneditor	editors_IDE
jitescript	development
GoodData-CL	development
thucydides	webapps
jruby-maven-plugins	other
Netbeans-Redmine-Integration	editors_IDE
Xcore	editors_IDE
Java-WebSocket-client	networking
couchjava	databases
querydsl	databases
maven-android-plugin	mobile
steam-condenser	other
Empire	development
rexster	development
hadoop-mapreduce	development
Residence	games
worldguard	games
XkcdViewer	mobile
org.ops4j.pax.runner	development
jgravatar	other
Android-Terminal-Emulator	mobile
howl	other
pegdown	other
directed-edge-bindings	webapps
railo	development
elephant-bird	webapps
nutch	other
xtext	editors_IDE
CassandraCompositeType	databases
wooki	other
zanmini	other
spring-batch-admin	webapps
Socket.IO-Java	networking
spring-data-graph-examples	other
erjang	other
basex-api	databases
softwaremill-common	other
RobolectricSample	development
riffle	other
Solandra	databases
android_packages_apps_Pacman	mobile
jmxutils	development
android_packages_wallpapers_MagicSmoke	mobile
gcontracts	other
android_packages_apps_Torch	mobile
seph	other
Play--Scaffold	other
twitter-text-java	webapps
AndroidPushNotificationsDemo	mobile
platform_packages_apps_phone	mobile
persistence	development
android-pedometer	mobile
hive	databases
MarteEngine	games
lucene-interval-fields	other
jpropel-light	development
couchdb-lucene	databases
Octobot	networking
S9	mobile
droolsjbpm-knowledge	other
MoveCraft	games
lightstone	games
wolips	other
droidgiro-android	mobile
whirr	networking
platform_packages_apps_mms	mobile
play--database	databases
android_packages_apps_CMPartsHelper	mobile
markdownj	other
jamendo-android	mobile
Elevation	graphics
Brion-Learns-OAuth	mobile
yuitest	development
cloudhopper-smpp	networking
cw-andtutorials	mobile
groovy-core	development
xapi-servlet	other
jdepend	development
cms-ce	other
jboss-as	other
LunaTerm	mobile
Weave	other
play-siena	databases
jbinlog	databases
Core	games
barnacle	mobile
SeriesGuide	mobile
colossal-pipe	development
ols	other
netty-tools	networking
latte	development
maybe-java	other
spring-data-document-examples	databases
DroidXBootstrap	mobile
jcommander	other
GLWallpaperService	other
Most-Pixels-Ever	graphics
izpack	development
nutz	other
Ivory	other
guice-automatic-injection	development
api	development
TimeFlow	other
MagicCarpet	games
wonderdog	other
osw-lib-java	other
weinre	development
joda-money	other
inconsequential	other
opencms-core	other
TwitterClient	webapps
orion.server	editors_IDE
play-search	other
Permissions	games
com.happyprog.tdgotchi	other
msgpack	development
oreilly_android	mobile
qsandra	databases
fiji	other
cascading	other
cascading-dbmigrate	databases
oozie	other
calculon	mobile
rapa	other
clojure-maven-plugin	development
dreamDroid	mobile
Factions	games
maven-training	other
GroupManager	games
eclipse-color-theme	editors_IDE
graphdb	databases
storm-kestrel	other
twitter4j	webapps
hibernate-validator	development
greplin-bloom-filter	other
android-ColorPickerPreference	mobile
j2me-oauth	other
java-simplegeo	other
java-apns	other
Pydev	editors_IDE
karaf	other
MobArena	games
OpenTripPlanner	other
android-archetypes	mobile
spring-data-jpa	databases
erlide	editors_IDE
Collections	other
patricia-trie	development
agit	mobile
jedis	databases
arquillian	development
Anki-Android	mobile
nodebox	graphics
hibernate-search	other
vidtry	mobile
arquillian-core	other
AndRoad	mobile
bitcoin-mobile-android	mobile
google-app-engine-jappstart	development
xwiki-enterprise	webapps
junit-interface	development
Giraph	other
plugin-Freetalk-staging	other
mustache.java	other
Resty	other
spring-amqp	development
studio3	other
kilim-erjang	other
openengsb-framework	other
irssiconnectbot	mobile
android-support-v4-googlemaps	mobile
jamm	other
jocl	other
leveldb	databases
extensions	development
Tickler	mobile
geohash-java	other
grendel	webapps
min	development
drools	other
maven-scala-plugin	development
SWFREtools	other
egit	editors_IDE
Java-WebSocket	networking
high-scale-lib	development
Register	games
jpatterns	other
LittleProxy	networking
awacs	other
siena	other
grouperfish	other
SamplePlugin	games
watchmaker	other
android_utils	mobile
android-smart-image-view	mobile
RPlay	other
moho	networking
jvm-compressor-benchmark	other
hibernate-memcached	development
socket.io-netty	networking
scale7-pelops	databases
spatial	other
orbeon-forms	webapps
cas	webapps
gremlin	other
cwac-thumbnail	mobile
testng-eclipse	editors_IDE
Open-Quark	development
mcpatcher	games
bobo	other
shindig	webapps
jforum2	webapps
jforum3	webapps
bndtools	editors_IDE
RSense.tmbundle	editors_IDE
fanfoudroid	mobile
GitHub-Stoplight	other
cascading.avro	other
args4j	development
Twig-Eclipse-Plugin	editors_IDE
smooks	other
OtRChat	other
GreenDroid	mobile
zxing-iphone	mobile
sicci_for_xcode	editors_IDE
webbit	networking
hoop	networking
core	other
security	other
hibernate-core	databases
Japid	development
solder	development
ooc	other
nerlo	databases
callmeter	mobile
apb	other
iConomy	games
android-junit-report	mobile
smack	other
Citizens	games
HackReduce	other
cloudata	databases
android-bankdroid	mobile
refactoring-to-rails	other
hawtdispatch	development
FBReaderJ	mobile
clojure-protobuf	networking
android-garage-opener	mobile
android_packages_apps_FileManager	mobile
cometd	webapps
riot	webapps
platform_frameworks_policies_base	mobile
platform_packages_apps_camera	mobile
sonatype-aether	editors_IDE
sitebricks	development
wicket	webapps
camel	development
java-memcached-client	databases
RecordBreaker	other
AsmackService	mobile
jboss-modules	development
gerrit-trigger-plugin	other
cqrs-lottery	other
ccnx	networking
jdbi	databases
jasmine-maven-plugin	development
tomighty	other
qi4j-core	development
tim-clojure-1.0-snapshot	other
memcached-session-manager	other
ScrapBukkit	games
platform_packages_apps_settings	mobile
c-geo	mobile
titanium-barcode	other
spring-social-facebook	development
megalon	databases
RhiNode	development
maven-trap	other
spring-integration	other
SpoutAPI	games
cwac-touchlist	mobile
jolokia	networking
play--pdf	other
HudsonPluginForPlay	other
hibernate-ogm	databases
quran_android	mobile
jsoup	other
git4idea	other
ksoap2-android	mobile
tocollege.net	webapps
hubroid	mobile
S2E	mobile
egit-github	editors_IDE
X-Trace	development
liquibase	databases
yeti	other
hibernate-tools	development
twitlogic	other
org.eclipse.mylyn.github	editors_IDE
hadoop-hdfs	other
twitter-2-weibo	webapps
jboss-as-maven-plugin	other
MyWarp	games
java-cloudfiles	other
droolsjbpm-tools	other
logprocessing	loggers
m2e-android	mobile
activemq	other
Towel	development
Spoutcraft-Launcher	games
emergency-service-drools-app	development
jangaroo-tools	development
jbehave-core	development
RSBot	games
Absolute-Android-RSS	mobile
surinx	development
Memcached-Java-Client	other
fuse4j	other
elasticflume	other
Scripts	other
pig-redis	databases
snappy	other
spring-amqp-samples	other
google-go-lang-idea-plugin	editors_IDE
aws-sdk-for-java	other
lightweight_trie	other
flyingsaucer	other
mongo-jdbc	databases
spring-android-samples	mobile
spring-batch	development
ant	development
pig	development
PermissionsEx	games
avro	other
structr	other
BPMN2-Editor-for-Eclipse	editors_IDE
linkedin-zookeeper	other
epublib	development
Mentor-Bank	other
MongoReduce	databases
thrudb	databases
SimpleServer	webapps
hadoop-book	other
connectbot	mobile
war	games
liferay-maven-sdk	development
DroidCouch	mobile
bigbird	other
Napalm	webapps
examples	other
felix	other
aspen	webapps
eurekastreams	other
decafbot	mobile
lucene-solr	other
GAHelloWorld	other
RapidFTR---BlackBerry-Edition	mobile
bitcoin-android	mobile
todo.txt-touch	mobile
sablecc	development
android-rackspacecloud	mobile
campyre	mobile
flume	loggers
zookeeper	networking
jsi	other
android_packages_inputmethods_LatinIME	mobile
flume-cassandra-plugin	databases
pipes	other
android_packages_apps_CMStats	mobile
OneSwarm	other
hawtdb	databases
bantam	other
console	other
textrank	other
Better-Arabic-Reshaper	mobile
Athena	other
servlet	other
ketama	development
eclipse-task-editor	editors_IDE
brix-cms	webapps
quickstart	other
fixture-factory	other
Minecraft-Server-Mod	games
joda-time	development
cw-lunchlist	mobile
Templatebread	mobile
Book-Catalogue	mobile
spring-framework	development
Moneychanger	other
osw-openfire-plugin	other
SpoutcraftAPI	games
Spout	games
jna	development
minerva	editors_IDE
api-examples	other
brut.apktool	development
AndroidBillingLibrary	mobile
dynmap	games
krati	databases
datafu	other
infinispan	databases
lasthbase	databases
lucene	other
rhino	other
m2eclipse-extras	editors_IDE
greenhouse	webapps
calopsita	development
clj-swingrepl	other
CloudBridge	development
meteo	loggers
osw-android	mobile
config	development
orman	development
mysticpaste	other
amu_automata_2011	other
snaptree	development
flumebase	databases
xwiki-platform	webapps
Twig-netbeans	editors_IDE
meetup.beeno	databases
android_packages_apps_CMUpdateNotify	mobile
liferay-plugins	other
android_page_curl	mobile
diaspora-android	mobile
github-api	other
stomple	networking
nbgit	other
phonegap-simjs	other
community	databases
guj.com.br	other
SuperSkein	graphics
Couverjure	development
neo4j-tutorial	other
blur	databases
USB_Host_Shield	other
shade	games
spring-data-document	databases
awaitility	development
atlas	other
Superuser	mobile
github-java-sdk	development
Wikipedia-noSQL-Benchmark	databases
gitblit	other
testng	other
operadriver	other
LWC	games
clj-json	development
s4	development
spring-data-keyvalue	databases
qpid	other
mahout	other
Arduino-IRremote	other
phonegap-android	mobile
jblas	other
android_packages_apps_Phone	mobile
flexmojos	development
Android-Error-Reporter	mobile
junit	development
browsermob-proxy	webapps
Mario-AI-Competition-2009	other
CraftBukkit	games
cwac-endless	mobile
libcouch-android	mobile
Android-AR-Kit	mobile
android_packages_apps_DSPManager	mobile
spring-data-jpa-examples	other
lorsource	webapps
maple-ide	other
vcap-java	other
DiabloMiner	other
spinscan	other
android_packages_apps_FM	mobile
retrofit	mobile
platform	other
SimpleNote-for-Android	mobile
java-workbook	other
maven-nar-plugin	other
Blockmania	graphics
xcode-hudson-plugin	other
spring-roo	development
hector	databases
Cryptosuite	other
smartsprites	graphics
arquillian-examples	other
platform_frameworks_base	mobile
rosyama	mobile
infinitest	other
liverepl	development
droolsjbpm-integration	other
nokogiri	other
floating-point-gui.de	webapps
ADWLauncher2	mobile
tempo	other
nagare	mobile
JSON-java	other
jboss-rails	other
platform_packages_apps_contacts	mobile
Webduino	other
limelight	other
resthub	development
jogl	graphics
spring-data-graph	development
playclipse	editors_IDE
frames	development
Spoutcraft	games
libgdx	other
elasticsearch	webapps
android_packages_providers_MediaProvider	mobile
hiho	development
mcMMO	games
cxf	other
facebook-android-sdk	mobile
congress	mobile
android_packages_apps_CMWallpapers	mobile
msgpack-rpc	other
caelum-stella	other
solr	other
studio2	editors_IDE
jclouds-examples	other
signpost	other
websms	mobile
android_packages_providers_CalendarProvider	mobile
Iris-Voice-Automation	other
Titanium-Android-AdMob-Module	mobile
robotium	other
rundeck	other
cakephp-netbeans	editors_IDE
grails-data-mapping	databases
SecureSmartCam	mobile
mixare	other
sonatype-tycho	other
gpslogger	mobile
hadoop-20	other
Plume	development
quercus-gae	other
press	other
functionaljava	development
asynchbase	databases
commandbook	development
RESTProvider	mobile
elephantdb	databases
yoga	development
gh4a	mobile
Minim	other
menagerie	other
iChat	other
minecraft-hey0-plugins	games
lljvm	development
fakereplace	development
threeten	other
studio2-rcp	editors_IDE
rest-client	other
JavaBeanstalkClient	other
dynalink	development
SyncMyPix	mobile
droid-fu	mobile
async	development
cucumber-netbeans-plugin	editors_IDE
couchdb4j	databases
activemq-apollo	networking
android-segmentedradiobutton	mobile
sitemesh2	other
speakeasy-plugin	development
imgscalr	graphics
cascading.hbase	databases
jreversepro	other
sitemesh3	other
blueprints	other
git-teamcity	development
geppetto	development
mididuino	other
cocos2d	mobile
maven-cli-plugin	development
bonecp	databases
SIREn	other
gitidea	editors_IDE
worldedit	games
bdbdatastore	databases
JGit	other
qedserver	webapps
emite	networking
phantm	other
platform_packages_apps_browser	mobile
athena	development
ZwitscherA	mobile
jdeb	development
jira4-git-plugin	other
jclouds	other
m2eclipse-wtp	editors_IDE
HNews	mobile
protograph	other
hector-examples	databases
maven-thrift-plugin	other
dmix	other
websocket-android-phonegap	mobile
play-gwt2	other
gwt-gae-image-gallery	webapps
wa-toolkit-android	mobile
irccat	other
The-Nature-of-Code	other
asmack	mobile
t7mp	development
msgpack-java	development
hey0-plugins	games
sbt-jetty-embed	development
tubaina	other
perforce-plugin	other
openmrs	other
sbt-eclipse-plugin	editors_IDE
cucumber-jvm	other
tika	other
brisk	databases
spark	webapps
eclim	editors_IDE
NFC-Contact-Exchanger	mobile
Quercus	development
hadoop	development
cdk	other
android-mapviewballoons	mobile
gluegen	graphics
jack-servlet	webapps
components	development
ec2-plugin	other
aws-toolkit-for-eclipse	editors_IDE
dyn.js	other
Ushahidi_Android	mobile
grails-core	other
jcollectd	development
Cloud9	other
sparsemapcontent	databases
jmd	other
combiner	development
quickdt	development
rhino-mirror	development
craftbook	games
tdd-tetris-tutorial	games
CraftIRC	games
open-experiments	other
sms-backup-plus	mobile
signpost-examples	other
storm-starter	other
play-morphia	databases
oauth_for_android	mobile
oreilly-gradle-book-examples	other
prevayler	databases
spring-social-samples	other
descriptors	development
scribe	other
opaz-plugdk	development
async-http-client	networking
pad	webapps
spring-data-keyvalue-examples	databases
wordnik-oss	databases
droidscript	mobile
ejemplos-clases-compiladores-e-interpretes	other
spring-test-mvc	development
bson4jackson	development
android_packages_apps_CMScreenshot	mobile
pygmalion	databases
android-emulator-plugin	mobile
vash	graphics
twitter-corpus-tools	other
xmemcached	other
Car-Cast	mobile
akka-zeromq-java	other
sharpen	development
hbase-dsl	databases
fcrepo	other
gora	databases
titanpad	other
TeaTimer	mobile
code_swarm	graphics
vote4music	webapps
gatk	other
TeleHash	other
lastfm-android	mobile
azkaban	other
spock	development
css-selectors	other
lettuce	networking
c-geo-opensource	mobile
basex	databases
GwtMobile	mobile
platform_packages_apps_music	mobile
nexus	development
Honu	other
rawr	development
jmustache	development
clustered-jruby	other
ViewServer	mobile
metrics	other
yaxim	mobile
fred-staging	webapps
etherpad	databases
tomcat70	other
zoie	other
goos-code	other
spring-modules	development
intellij-community	editors_IDE
udig-platform	other
Ektorp	databases
subversion-plugin	other
platform_packages_apps_launcher	mobile
Kundera	databases
jruby-ossl	development
sikuli	other
timer-for-android	mobile
LuaEclipse	editors_IDE
sqoop	databases
titanium-c2dm	other
ProgrammingAndroidExamples	mobile
jchronic	other
idea-markdown	other
CloudStack	databases
imgur-Uploader	mobile
DevsmartLib-Android	mobile
spring-example-gae	other
sshj	networking
android-actionbar	mobile
shiro	development
tahrir	webapps
DrupalCloud	other
android-viewflow	mobile
360-Engine-for-Android	mobile
spring-security-oauth	other
gwt-maven-plugin	development
java-uuid-generator	other
jesque	development
droolsjbpm	other
json	other
scala-parallel	development
maven-android-plugin-samples	mobile
modeshape	other
mongo-hadoop	databases
gwt-node	other
programming-amazon-ec2	other
graylog2-server	loggers
OCM	databases
wonder	webapps
phonegap-blackberry-webworks	mobile
KeptCollections	other
twilio-java	development
android_game_examples	games
stack	development
rest	development
java-koans	other
maven-yamlpom-plugin	other
UrlImageViewHelper	webapps
BigBrother	other
hadoop-common	other
hbasene	databases
sat3	other
android_packages_apps_Bluetooth	mobile
natty	other
spring-social	other
ScrollableTabHost-for-Android	mobile
Tweety	mobile
vraptor	development
jboss-msc	other
johm	development
simplejpa	databases
Bukkit-Plugin-Generator	games
android-async-http	mobile
Sizzle	other
guvnor	other
Android-ViewPagerIndicator	mobile
Multiverse-Core	games
android-viewbadger	mobile
jackrabbit	development
processing-js	graphics
OWASP-CSRFGuard	other
android-api	mobile
bnd	other
spectrotune	other
reddit-is-fun	mobile
Programacion2_2_5_2011	other
ioke	development
polyglot-maven	development
astrid	mobile
jsunit	development
RHIPE	other
stringtemplate4	development
disruptorWizard	development
Lumberyard	databases
hs4j	databases
maven-plugins	other
contactlist	other
General	games
minequery	other
social	webapps
uk.co.jasonfry.android.tools	mobile
ccw	other
Bukkit	games
standup-timer	mobile
Vega	other
aym-cms	webapps
Dolomite	networking
enclojure	editors_IDE
Heroes	games
liblinear-java	other
android_libcore	mobile
hbase	databases
promoted-builds-plugin	development
keepassdroid	mobile
netbeans-plugin	editors_IDE
m2e-core-tests	editors_IDE
sensei	databases
jenkins_campfire_plugin	other
hqapi	webapps
MicDroid	mobile
android-intent	mobile
DirectMemory	development
idea-sbt-plugin	other
resty-gwt	other
ideavim	editors_IDE
spring-hadoop	other
rsense	development
Deacon	mobile
tapx	other
bitcask-java	databases
coffeescript-netbeans	editors_IDE
antlr4	other
hudson	other
codefellow	editors_IDE
horizontalpager	mobile
android-rss	mobile
play-jobs	webapps
swagger-codegen	development
jbpm	other
paper2ebook	other
wikihadoop	other
android-database-sqlcipher	databases
YCSB	other
twitterdroid	mobile
cwac-wakeful	mobile
streamgraph_generator	graphics
crunch	other
jgit	editors_IDE
kissy-tools	other
hotpotato	networking
cwac-merge	other
PermissionsBukkit	other
biojava	other
hbase-book	databases
sign-in-with-twitter	webapps
compress	other
farebot	mobile
zxing	other
netbeans-php-enhancements	editors_IDE
GwtMobile-PhoneGap	mobile
chipKIT32-MAX	editors_IDE
MinecartMania	games
blueredis	databases
play.rules	other
jack	databases
GwtMobile-UI	mobile
airbrake-android	mobile
HeroChat	games
slf4j	loggers
spring-data-commons	databases
jvm-serializers	other
android_packages_apps_SoundRecorder	mobile
restfulie-java	development
asterisk-java	networking
osw-model	other
adbcj	databases
sbt-plugin	other
mvel	development
log4j	loggers
cloby	other
simplegeo-android-client	mobile
mvnsh	other
Osmand	mobile
Jetwick	webapps
sthlmtraveling	mobile
Examples	mobile
OG-Platform	other
jmeter-maven-plugin	other
NewQuickAction3D	mobile
ADW.Theme-Template	webapps
gridgain	other
enumerable	development
javasysmon	other
vcloud	development
asakusafw	other
LazyList	mobile
deft	webapps
Yaaic	mobile
phonegap-system-notification-plugin	mobile
faces	other
javaewah	other
Air-Mobile-Extensions	mobile
off-plugin	editors_IDE
zkclient	other
nbscala	editors_IDE
AndroidSDK-RecipeBook	mobile
android_packages_apps_Calendar	mobile
nimbus	other
jsonapi	development
asakusafw-examples	other
java_practical_semantic_web	other
hist4j	other
tapestry5-hotel-booking	other
OSCeleton-examples	other
kilim	other
struts2	other
